111111111111111111111111111111111111111111
10P0000000C000C000C000C1111111111111111111
10000000C1110000C0000C00000C00C000C00000C1
1111111CC000011111CC0000000011100000C00001
10000000C000000000C000000000C00000000C00E1
111111111111111111111111111111111111111111