111111111111111111111111111111111111111111
11PL0000L00C000C000C000C111111111111111111
10000000C11100L0C0000C00000C00C000C00000C1
1111111CC000011111CC0000000011100000C00001
10000000C00000L011111111111111110C00000001
10000C000L000C000L000C000000000111111C0001
110L000L00C000C000C000C1111111111111111111
1111111CC000011111CC0000000000000000C000E1
111111111111111111111111111111111111111111